
enojar = εξαγριώνω, ενοχλώ
agotar = torturar, molestar, agobiar
lastimar = hurt
atormentar = torturar
angosto = estrecho
angustiar = upset, cause distress
a lo largo de = κατά μήκος (a lo largo de mi cuerpo)
piropo = κομπλιμέντο
bostezar (bostezo) = yawning
envidia = envy
rabia = anger, rage
estornudar = φτερνίζομαι
a pesar de = παρά, παρόλο
bulto = package, piece of luggage
por más que = as much as (even though)
trueno = thunder
valiente = courageous, brave
capucha = κουκούλα
derretir = melt
avispa = σφήκα
corromper = διαφθείρω
irrompible = unbreakable
chillar = shout, scream
placentero = pleasant
agradable = pleasant
gemir = μουγκρίζω
en alto
empaste = filling (in teeth)
jadear (jadeo), resollar = gasp (λαχανιάζω)
censura = λογοκρισία
civilización
imperdible = παραμάνα
mandíbula = πηγούνι
regañar = τη λέω σε κάποιον, to tell off
fructífero = productivo
frotar(se) = ξύνω(ομαι)
obediente = υπάκουος
tebeo = comic
precaución = επιφύλαξη
cachear = ελέγχω/ψάχνω κάποιον σωματικά
el forense = ιατροδικαστής
soso = bland, tasteless, dull, boring
atravesar = cruzar = διασχίζω
agredir = assault, abuse
dar palmadas = χειροκροτώ
innato = έμφυτο, inborn
la llama = flame = φλόγα
mirar de reojo = μισοκοιτάζω
la pala = φτυάρι
a no ser que = unless
de no ser por = had it not been for
sobornar = δωροδοκώ
el soborno = δωροδοκία (the bribe)
erudito = λόγιος
mendigar = ζητιανεύω
lograr = manage, achieve
azafata, asistente de vuelo = αεροσυνοδός
escalofrío = ρίγος, chills
hurgarse la nariz = rascarse la nariz = σκαλίζω τη μύτη
consolar = alentar = παρηγορώ
barrer = σκουπίζω
saquear = κάνω έφοδο = loot
gruñir = moan, groan, complain
colocado = stoned
rasgar = desgarrar = σκίζω
presumir que, alardear de, jactarse de = καυχιέμαι
ir/salir de juerga = out to party
alivio = ανακούφιση
la lupa = μεγεθυντικός φακός
torpe = άτσαλος, περίεργος
tentar = δελεάζω = tempt
cojear = κουτσαίνω
descarado = desvergonzado
me la pela = me la suda = δε δίνω δεκάρα
aposta = a propósito = deliberadamente
a pesar de (que) + subjuntivo
insinuar = imply = υπονοώ
a pesar de = pese a = y eso que = despite, regardless, even if
quillo = αντίθετο του pijo (catalunya)
macarra = bruto, vulgar
obsceno = πρόστυχο
astuto, pícaro = πονηρό, naughty
pedazo = κομμάτι
reprochar = reproach = κατηγορώ, επιπλήτω
υποχώρηση = rendición (rendirse), cesión (ceder)

braguetazo = κελεπούρι
igual número = τόσο όσο (θα σου δώσω τόσα όσα της χρωστάς)
interpretar (role, song) = perform
representar (una obra) = perform
desbordar = ξεχειλισμένος, πηγμένος, overflowed
meter cañas = dar cañas = get it going, intensify
poner al día = ενημερώνω κάποιον, bring up to date
pizca = λιγάκι
rehén = όμηρος
estrías = ραγάδες
estrellarse = συντρίβομαι

----------------------------------------------------------------------------
TO ASK:

picudo = μυτερός
desafío, reto = challenge
una rana = βατράχι
sandía = καρπούζι
soborno, sobornar = δωροδοκία
minusválido = ανάπηρος
rezar = προσεύχομαι

antojarse
autoestima
ternura
pretender = προσπαθώ να κερδίσω/αποκομίσω
fingir, aparentar
la acera = πεζοδρίμιο
el pecado = αμαρτία
fastidiarse
agobiarse
liarse
ligar
ahogar
acojonarse
dudar = διστάζω
vacilar = διστάζω
pinche ojete = άχρηστο αρχίδι
desviado = στραβό
rendirse = παραδίδομαι, παραιτούμαι, το βάζω κάτω
el hogar = home
el rincón = dark side
la cesta = καλάθι
se debe a = οφείλεται
digerir = χωνεύω
churri = gomena
desquitarse con alguien/algo = ξεσπάω σε κάποιον
cuajar = στρώνει χιόνι
el calcetín = κάλτσα
hacer cosquillas = γαργαλάω
compadecerse de alguien = λυπάμαι κάποιον
te estás burlando de mi = με δουλεύεις
burlarse de = κοροιδεύω
burlar a alguien = ξεγελάω
chantaje/chantajear = εκβιασμός
varonil = ανδροπρεπής, masculine
despiadado/a = σκληρός, άκαρδος
inundación = πλημμύρα
rehusar (hacer algo) = αρνούμαι να
acudir (a) = καταφεύγω
fanfarrón, presuntuoso = ψώνιο, αλαζών
travieso = άτακτος
cursi = γλυκανάλατο
cuchi = γλυκούλι


chismorreo
chisme
cotilleo

